亮白面膜	亮白(VH)　面膜(Na)
保濕乳液	保濕(VH)　乳液(Na)
保濕乳霜	保濕(VH)　乳霜(Na)
保濕水凝乳	保濕(VH)　水凝乳(Na)
保濕水凝凍	保濕(VH)　水凝凍(Na)
保濕水凝霜	保濕(VH)　水凝霜(Na)
保濕水凝露	保濕(VH)　水凝露(Na)
修容蜜粉	修容(VH)　蜜粉(Na)
修容蜜粉餅	修容(VH)　蜜粉餅(Na)
修護乳液	修護(VH)　乳液(Na)
修護乳霜	修護(VH)　乳霜(Na)
修護唇膏	修護(VH)　唇膏(Na)
修飾底霜	修飾(VH)　底霜(Na)
假睫毛膏	假(VH)　睫毛膏(Na)
全能乳液	全能(VH)　乳液(Na)
全能乳霜	全能(VH)　乳霜(Na)
凝水面膜	凝水(VH)　面膜(Na)
化妝水凝露	化妝(VH)　水凝露(Na)
吸油面紙盒	吸油面紙(Na)　盒(Nf)
唇頰蜜粉盒	唇頰蜜粉(Na)　盒(Nf)
奇蹟乳液	奇蹟(VH)　乳液(Na)
平衡乳液	平衡(VH)　乳液(Na)
暈染眉筆	暈染(VH)　眉筆(Na)
柔膚乳液	柔膚(VH)　乳液(Na)
柔膚蜜粉	柔膚(VH)　蜜粉(Na)
極萃白	極(Dfa)　萃白(VH)
氣墊粉餅組	氣墊粉餅(Na)　組(Nf)
氣墊粉餅霜	氣墊粉餅(Na)　霜(Na)
水凝乳液	水凝(VH)　乳液(Na)
泥面膜	泥(Na)　面膜(Na)
活泉水凝凍	活泉(VH)　水凝凍(Na)
活膚乳液	活膚(VH)　乳液(Na)
液面膜	液(Na)　面膜(Na)
淨顏面膜	淨顏(VH)　面膜(Na)
潔顏乳霜	潔顏(VH)　乳霜(Na)
潤膚乳液	潤膚(VH)　乳液(Na)
潤膚乳霜	潤膚(VH)　乳霜(Na)
煥膚乳液	煥膚(VH)　乳液(Na)
煥膚乳霜	煥膚(VH)　乳霜(Na)
粉刺寶藥	粉刺寶(Na)　藥(Na)
粉底乳霜	粉底(VH)　乳霜(Na)
精華乳液	精華(VH)　乳液(Na)
精華乳霜	精華(VH)　乳霜(Na)
精華藥	精華(Na)　藥(Na)
紓壓水雲霧	紓壓(VH)　水雲霧(Na)
美白寶藥	美白寶(Na)　藥(Na)
翹唇筆	翹(VH)　唇筆(Na)
翹唇蜜	翹(VH)　唇蜜(Na)
腮紅版	腮紅(Na)　版(Na)
花蜜粉底霜	花蜜(Na)　粉底霜(Na)
蜂蜜唇膏	蜂蜜(Na)　唇膏(Na)
補水面膜	補水(VH)　面膜(Na)
調理水藥	調理水(Na)　藥(Na)
護唇蜜	翹(VH)　唇蜜(Na)
護手乳霜	護手(VH)　乳霜(Na)
身體乳霜	身體(Na)　乳霜(Na)
遮瑕蜜粉	遮瑕(VH)　蜜粉(Na)
鎖水面膜	鎖水(VH)　面膜(Na)
防曬乳液	防曬(VH)　乳液(Na)
防曬乳霜	防曬(VH)　乳霜(Na)
防護乳液	防護(VH)　乳液(Na)
隔離乳液	隔離(VH)　乳液(Na)
隔離乳霜	隔離(VH)　乳霜(Na)
雙面膜	雙(Nfc)　面膜(Na)
面膜舞獅子	面膜(Na)　舞獅子(Na)
魔唇筆	魔(VH)　唇筆(Na)
